Geschwister: брат и сестра
Kenntnisse: знания
Kosten: расходы
Zinsen: проценты
abbauen: сносить, демонтировать
abgeben: отдавать, сдавать
abholen: заходить за
abhдngen: зависеть
ablehnen: отклонять
abmelden: сообщать об отъезде
achten: обращать внимание (на что-либо)
allein: один, одна, одно, одни
allerdings: разумеется, правда
allmдhlich: постепенно
anbieten: предлагать (что-либо)
anbringen: прикреплять
anfangs: вначале, сначала
anhцren: слушать
ankommen: прибывать, приходить, приезжать
anmelden: сообщать, докладывать
annehmen: принимать
anschlieЯen: привязать, подключить
ansehen: рассматривать
anstellen: зачислять, принимать
anstrengend: утомительный, напряжённый
anwenden: употреблять, применять (знания)
anziehen: надевать, обувать
arbeitslos: безработный
arm: бедный
auffordern: предлагать
aufgeben: задавать, отправлять
aufgehen: всходить, восходить
aufhдngen: вешать, развешать
aufhцren: прекращать
aufkommen: входить, возникать
aufpassen: быть внимательным
aufregen: волновать, возбуждать
aufrдumen: убирать, прибирать
aufschieben: откладывать, менять сроки
aufschlagen: разбивать (орехи, яйца)
aufstehen: подниматься, вставать
aufstoЯen: распахивать
aufwдrts: наверх, вверх
ausgeben: раздавать, расходывать
ausgehen: выходить
ausgerechnet: как раз, как нарочно, именно
ausgezeichnet: отличный, превосходный
aushalten: выдерживать, выносить
ausladen: выгружать, рагружать
auslдndisch: зарубежный
ausmachen: выключать (газ, свет)
ausmessen: вымерять
auspacken: распаковывать
ausrechnen: вычислять
ausschlafen: высыпаться
ausschreiben: записывать
aussehen: выглядеть
aussprechen: произносить, выговаривать
aussteigen: выходить, сходить, высаживаться
ausstelen: экспонировать
aussuchen: выбирать, отбирать
ausziehen: снимать, раздевать
auЯer: кроме
auЯerdem: кроме (помимо, сверх) того
auЯerhalb: за пределами
backen: печь, выпекать
baden: купать
bar: наличные
bauen: строить
beachten: соблюдать, учитывать
beantragen: подавать заявление
bedienen: обслуживать (кого-либо, машину)
beenden: прекращать
befreien: освобождать
befriedigen: удовлетворять
befriedigend: удовлетворительный
befьrchten: опасаться
begegnen: встречать
begrьЯen: приветствовать
behalten: оставлять, сохранять
behandeln: обращаться
behaupten: утверждать, удерживать
behutsam: осторожный, осмотрительный
beide: оба, обе
beinahe: почти, чуть
bekannt: известный
belegt: хрипловатый
beleidigen: обижать, оскорблять
belieben: соизволить, желать, хотеть
bemerken: замечать
bemьhen: стараться
benutzen: пользоваться, использовать
bequem: удобный, уютный
beraten: давать совет
berechnen: вычислять
bereit: готовый
berichten: сообщать
beruflich: профессиональный, служебный
beschliЯen: решать, постановлять
beschweren: обременять
beschдftigen: занимать(ся)
besetzt: занимать место
besitzen: владеть, обладать
besonders: особенно
besorgen: исполнять, выполнять (поручения и т.п.)
bestehen: выдерживать
bestellen: заказывать
bestimmen: назначать, устанавливать
bestimmt: определённо, точно
bestдtigen: подтверждать
betragen: составлять, равняться
bevor: прежде чем, пока не
bewegen: двигать, передвигать
beweisen: доказывать
bewerben: подать заявление о приеме на работу
bewerten: оценивать
biegen: гнуть, сворачивать
bieten: предлагать
bilig: дешевый
billig: дешёвый, жалкий, убогий
bischer: до сих пор
bitten: просить
blass: бледный
blau: синий, пьяный
blond: светловолосый
blьhen: процветать, цвести
bohren: сверлить, бурить
braten: жарить (мясо, рыбу)
braun: коричневый
brechen: (раз)ломать, разбивать
breit: широкий
bremsen: тормозить
buchen: заказывать, бронировать
bцse: злой, сердитый
dabei sein: собираться
dagegen: против этого
damals: тогда; в то время
damit: чтобы; с тем, чтобы
dankbar: благодарный
das Abgas: выхлопные газы
das Abitur: выпускные экзамены
das Altenheim: дом престарелых
das Amt: должность, учреждение
das Angebot: предложение
das Aufsegen: внешний вид
das Ausland: заграница
das Becken: раковина
das Bein: нога
das Blatt: лист
das Blut: кровь
das Bundesamt: государственное ведомство
das Bьgeleisen: утюг
das Dach: крыша
das Ding: вещь
das Dorf: деревня, село
das Einkommen: доход
das Erdgeschoss: первый этаж
das Ereignis: событие, происшествие
das Ergebnis: результат, отчет, вывод
das Feuer: огонь, костер
das Fieber: страсть, температура
das Gebiet: район, область
das Gebirge: система гор
das Gebдude: здание
das Gefьhl: чувство
das Gehalt: зарплата
das Gericht: блюдо (еда), суд
das Gerдt: прибор, инструмент
das Gesetz: закон
das Gewitter: гроза
das Hemd: рубашка
das Holz: древесина
das Kissen: подушка
das Klima: климат
das Knie: колено
das Konto: счет
das Lebensmittel: пищевые продукты
das Medikament: медикамент
das Misverstдndnis: непонимание
das Mitglied: член (организации)
das Mittel: средство
das Nahrungsmittel: пищевые продукты
das Ohr: ухо
das Paket: сверток, пакет
das Pech: неудача, смола
das Projekt: проект
das Recht: право
das Schaufenster: витрина
das Schiff: судно
das Schloss: зАмок, замОк
das Spielzeug: игрушка
das Tal: долина
das Trinkgeld: чаевые
das Ufer: берег, побережье
das Verbrechen: преступление
das Verfahren: способ, технология
das Vergnьgen: удовольствие
das Verhalten: поведение, отношение
das Verhдltnis: соотношение
das Verkehrsmittel: транспортное средство
das Verstдndnis: понимание
das Vorurteil: предрассудок
das Werk: дело, произведение
das Werkzeug: орудие, инструмент
das Wohl: благополучие
das Zeichen: знак, сигнал
das Zeug: вещи, одежда
das Zeugnis: свидетельство
das Ziel: цель, финиш
dauernd: продолжительный, длительный
decken: накрывать на стол
der Anfang: начало
der Angestelle: служащий
der Anrufer: звонящий
der Anwalt: адвокат
der Anzug: костюм
der Arbeitnehmer: служащий
der Arbietgeber: работодатель
der Auftrag: поручение
der Aufzug: лифт
der Ausdruck: выражение
der Autosammler: аккумулятор машины
der Bach: ручей
der Bahnsteig: перрон
der Bau: стройка
der Bauch: живот
der Beamte: гос.служащий
der Bedart: потребность, спрос
der Bekannte: знакомый
der Bereich: район
der Besen: веник
der Betrieb: завод, предприятие
der Betriebsrat: производственный совет
der Boden: грунт, почва
der Eindruck: впечатление
der Eintritt: вход, вступление
der Enkel: внук
der Fall: случай
der Fehler: ошибка
der Finger: палец (на руке)
der Fortschritt: прогресс
der Frieden: мир
der FuЯgдnger: пешеход
der Gedanke: мысль, идея
der Gegenstand: тема, предмет
der Geschmack: вкус
der Gewinn: прибыль
der Griff: рукоятка, прием
der Grund: земля, грунт
der Hals: шея, горло
der Handel: торговля
der Haushalt: семейный бюдет
der Himmel: небо
der Hinweis: указание, ссылка
der Hof: двор
der Husten: кашель
der Inhalt: содержание
der Jugendliche: подросток
der Knopf: пуговица
der Kredit: кредит
der Kunde: клиент
der Kцnig: король
der Kцrper: тело, туловище
der Kьnstler: художник
der Laden: ставень, небольшой магазин
der Lastwagen: грузовой автомобиль
der Lohn: зарплата
der Misserfolg: неудача
der Mond: луна
der Mord: убийство
der Mut: мужество, смелость
der Mьlleimer: мусорное ведро
der Nebel: туман
der Notruf: экстренный вызов
der Ofen: печь, печка
der Pass: паспорт, перевал
der Pfannkuchen: пончик
der Plan: план, прирост
der Rand: край, ободок, окраина
der Ratschlдge: совет
der Raum: помещение
der Schatten: тень
der Schmuck: украшение
der Schnee: снег
der Schnupfen: насморк
der Schritt: шаг
der Schutz: защита, охрана
der Sitz: сидение, место
der Sprung: прыжок, скачок
der Standpunkt: точка зрения
der Star: звезда, скворец
der Stau: пробка, затор
der Stecker: штекер, вилка
der Stock: этаж
der Stoff: ткань, материал,ь вещество
der Strand: морской берег, пляж
der Streik: забастовка
der Sturm: буря, шторм
der Teil: часть, доля
der Titel: звание, титул
der Unterricht: преподавание, занятия
der Unterschied: разница, различие
der Verbrecher: преступник
der Verdacht: подозрение
der Verlust: потери, убытки
der Versuch: опыт, эксперимент
der Vertrag: договор, контракт
der Vertreter: представитель
der Verwande: родственник
der Vorhang: штора, занавес
der Vorschlag: предложение
der Vorteil: польза, выгода
der Vortrag: доклад, лекция
der Wert: стоимость, значение
der Wetterbericht: сводка погоды
der Wind: ветер
der Witz: шутка, острота
der Zeuge: свидетель
der Zufall: случай, случайность
der Zustand: состояние, положение
der Zweck: цель, назначение
der Zweifel: сомнение
deutlich: ясный, отчётливый
dick: толстый, густой
die Abreise: отъезд
die Abteilung: отдел
die Alarmanlage : сигнализация
die Anfrage: запрос
die Ankunft: прибытие
die Anmeldung: регистрация
die Arbeitbedingung: условия работы
die Art: вид, сорт, способ
die Aufgabe: задача, задание
die Ausbildung: обучение
die Ausgabe: издание, расходы
die Auskunft: справка
die Bahn: дорожка
die Bedingung: условие, предпосылка
die Beratung: обсуждение
die Beratungfirma: консультационная фирма
die Besserung: улучшение
die Betriebsleitung: управление предприятием
die Bevцlkerung: население
die Bewegung: движение
die Beziehung: отношения, связи
die Bitte: просьба
die Breite: ширина, широта
die Bremse: тормоз, слепень
die Bundeswehr: вооруженные силы
die Bьrste: щётка
die Darstellung: изображение
die Dienstleistung: бытовое обслуживание
die Diдt: диета
die Drogerie: парфюмерия, аптечка
die Ecke: угол
die Ehe: брак
die Eheberaterin: консультант по браку
die Eintrittkarte: входной билет
die Einzelheit: подробность, доход
die Entschuldigung: оправдание
die Erde: земля
die Erfahrung: опыт
die Existenz: существование
die Feier: праздние
die Figur: фигура
die Flдche: плоскость
die Forschung: научное исследование
die Freude: радость
die Freundschaft: дружба
die Gebrauchsanweisung : инструкция по эксплуатации
die Geburt: роды, рождение
die Gebьhr: сбор, пошлина
die Gefahr: опасность
die Gegend: местность
die Gelegenheit: повод, случай
die Gemeinschaft: общность
die Geschichte: история (предмет)
die Gesellschaft: общество
die Gesundheit: здоровье
die Gewerkschaft: профсоюз
die Gewohnheit: привычка
die Glьhbirne: лампочка
die Grenze: граница, предел
die Grippe: грипп
die Heimat: родина
die Heizung: отопление
die Hilfe: помощь
die Hitze: жара, зной
die Hochschule: ВУЗ
die Hoffnung: надежда
die Hдlfte: половина
die Hцhe: высота, размер
die Insel: остров
die Jahrezeit: время года
die Jugend: молодость
die Kette: цепочка
die Kneipe: забастовка
die Kohle: уголь
die Kraft: сила
die Krankheit: болезнь
die Krise: кризис
die Kritik: критика
die Kдlte: холод, стужа
die Kьste: побережье (морское)
die Lage: положение, обстановка
die Lebensgefahr: опасность для жизни
die Leistung: результат работы
die Leitung: руководство
die Liste: список
die Luft: воздух
die Lдnge: длина
die Lьge: ложь
die Mannschaft: команда
die Mauer: стена, ограда
die Mehrheit: большинство
die Meinung: мнение
die Menge: множество
die Miete: квартплата
die Mitbestimmung: принятие решения
die Mitte: середина, центр
die Mьhe: труд, усилия
die Nachfrage: спрос
die Nadel: иголка
die Natur: природа
die Nichte: племянница
die Not: нужда, необходимость
die Note: нота, оценка
die Panne: поломка
die Pfanze: растение
die Pille: таблетка
die Praxis: практика
die Prьfung: экзамен
die Psychologie: психология
die Rede: речь, разговор
die Regierung: правительство
die Reihe: ряд, шеренга
die Rettung: спасение
die Richtung: направление
die Sache: вещи, вопрос
die Scheer: ножницы, клешня
die Schlagzeile: крупный заголовок
die Schuld: вина, долг
die Schwerigkeit: трудность, затруднение
die Sehenswьrdigkeit: достопримечательность
die Sendung: посылка, перевод
die Sicherheit: безопасность
die Socke: носок
die Sorge: забота
die Speise: пища, еда
die Spritze: шприц, укол
die Steckdose: розетка
die Stelle: место, пункт
die Stellung: положение, польза
die Strafe: наказание, штраф
die StraЯenbahn: трамвай
die Strecke: расстояние
die Stufe: ступенька
die Tabelle: таблица
die Tablette: таблетка
die Tante: тётя
die Tapete: обои
die Tat: действие
die Treppe: лестница
die Tдtigkeit: деятельность
die Umwelt: окружающая среда
die Untersuchung: исследование
die Veranstaltung: мероприятие
die Verantwortung: ответственность
die Verbindung: связь
die Verletzung: ранение, рана
die Versammlung: собрание
die Versicherung: уверенность, страхование
die Vorstellung: представление
die Waffe: оружие, вооружение
die Wahl: выборы
die Wahrheit: правда, истина
die Ware: товар, изделия
die Welt: мир, вселенная
die Werbung: реклама
die Werkstatt: мастерская
die Wirklichkeit: действительность
die Wirkung: влияние, действие
die Wirtschaft: экономика, народное хозяйство
die Wolke: облако, туча
die Zeitschrift: журнал
die Цffentlichkeit: общественность, гласность
die Ьberzeugung: убеждение
die Ьbung: упражнение
dienen: служить
direkt: прямо
diskutieren: обсуждать, спорить
doof: глупый
drehen: вертеть, вращать
drin: внутри
dringend: срочный, неотложный
drinnen: внутри
drьben: по ту сторону
dumm: глупый
dunkel: темный
durchschnittlich: средний
duschen: принимать душ
dьnn: тонкий, редкий
eben: именно, как раз
ebenfalls: также, тоже
egal: безразличный
ehemalig: прежний, бывший
ehrend: славный, почётный
ehrlich: честный
eigen: собственный
eigene: собственный
eilen: спешить, торопиться
einfach: простой
einfallen: обрушиваться, вторгаться
einfьhren: ввозить
einige: несколько, некоторые
einkaufen: покупать
einrichten: обставлять, организовать
einsam: одинокий
einschalten: включать
einsetzen: вставлять, вводить
einsperren: загораживать
einstellen: помещать, расставлять
einverstanden sein: быть согласным
einzeln: одиночный
einziehen: вдевать, втягивать
einzig: единственный
elektrisch: электрический
empfehlen: рекомендовать, советовать
eng: тесный, узкий
entdecken: обнаруживать
enthalten: содержать
entkommen: скрыться, избежать
entlassen: увольнять, выпускать
entschlieЯen: решить, принять решение
entstehen: возникать
entweder ... oder: или ... или
entwerfen: намечать
entwickeln: развивать
erfinden: изобретать
erfolgreich: успешный, удачный
ergдnzen: дополнять, добавлять
erhalten: сохранять
erhцhen: повышать
erinnern: напоминать
erklдren: объяснять
erkundigen: осведомляться
erlauben: разрешать, позволять
erleben: пережить, испытать
ermorden: убивать (предумышленно)
ernst: серьезный
erscheinen: появляться
erschieЯen: застрелить
erschrecken: испугать
erwachsen: взрослый
erwarten: дожидаться
erwerben: получать, зарабатывать
erziehen: воспитывать
erzдhlen: рассказывать
erцffnen: открывать, начинать
etwa: около
fallen: падать
falsch: неправильный
fangen: ловить, задержать (преступника)
fast: почти
faul: ленивый, гнилой
fehlen: недоставать, не хватать
fein: тонкий
fern: далекий
festhalten: крепко держать
feststellen: устанавливать
feucht: сырой, влажный
fit: быть в форме
flach: плоский, мелкий
fliehen: убежать
flieЯen: течь, литься
flьchten: убегать, спасаться бегством
folgen: следовать, идти (за кем-либо)
frech: наглый
fremd: чужой
frieren: мерзнуть, зябнуть
froh: веселый, довольный
fьhlen: чувствовать, ощущать
fьrchten: бояться
gebrauchen: употреблять
gefangen: пленный
gefдhrlich: опасный, рискованный
gegen: по отношению к, против
gehцren zu: принадлежать
gelb: жёлтый
gelingen: удаваться
gemeinsam: вместе
gemьtlich: уютный, приятный
genau: точный
genauso: точно также как
genьgen: быть достаточным
gerade: прямо, ровно
geraten: попасть, очутиться
gern: охотно
gesamt: целый
geschehen: происходить, случаться
gestrichen: крашеный
gewцhnen: приучать, привыкать
gewцhnlich: обыкновенный, обычный
gieЯen: лить, наливать
giftig: ядовитый
glatt: гладкий
glauben: полагать
gleich: равный, одинаковый
glьcklicherweise: к счастью
grau: серый, седой
greifen: схватить, браться
groЯzьgig: щедрый
grundsдtzlich: принципиальный
grьn: зелёный
grьnden: основывать, создавать
gьnstig: благоприятный
handeln: торговать
hassen: ненавидеть
heizen: отапливать
heiЯ: жаркий, горячий
hell: светлый
herrschen: править, господствовать
herstellen: изготовлять
herunterladen: загружать (почту)
hiermit: этим, сим, настоящим
hinfallen: падать, упасть (на землю)
hinstellen: ставить, становиться
hinten: позади, сзади
hoch: высокий
hoffen: надеяться
holen: приносить
hundrig: голодный
husten: кашлять
hдngen: висеть, вешать
hдsslich: некрасивый
hдufig: частый
hцflich: вежливый, учтивый
hьbsch: красивый
innen: внутрь
innerhalb: внутри
insgesamt: в целом, всего
interessieren: интересоваться
inzwischen: между тем
irgendwo: где-нибудь, где-либо, где-то
jagen: охотиться, преследовать
je: когда-нибудь, когда-либо
je  ...  desto: чем ... тем
jedenfalls: во всяком случае
jeder: каждый
jedoch: однако же
jemand: кто-то
kaum: едва, с трудом, насилу
kitschig: безвкусный, пошлый
klagen: жаловаться, сетовать
klemmen: прищемить, заедать
klettern: лазить, выбираться
klingeln: звонить
klopfen: стучать, похлопать
klug: умный, толковый
knapp: тесный, узкий
kochen: варить, готовить (пищу)
komisch: странный, комичный
kopieren: копировать
kostenlos: бесплатный
kriegen: получать, схватывать
kritisieren: критиковать
krдftig: сильный
kurz: короткий
kдmpfen: бороться
kьmmern: есть дело
kьndigen: увольнять, отказываться, расторгать
kьnstlich: искусственный
kьrzlich: недавний
kьssen: целовать
lachen: смеяться, хохотать
landen: приземляться
langsam: медленный, тихий (о движении)
langweilen: надоедать (чем-либо)
langweilig: скучный
lassen: позволять, велеть
laut: вслух, громко
lebendig: живой
lecker: лакомый, аппетитный, вкусный
ledig: холостой, незамужняя
leer: пустой, незанятый
leicht: лёгкий
leihen: брать взаймы
leise: тихий, едва слышный
leisten: совершать, делать
letzte: последний
leuchten: светиться
lieber: лучше, охотнее, скорее
liefern: поставлять, выпускать
linke: левый
loben: хвалить
lohnen: иметь смысл
los: свободный
losgehen: отправляться
lustig: весёлый, радующийся
luxuriцs: роскошный
lцsen: развязывать, отклеивать
lьgen: лгать, врать
mager: постный, нежирный, худой
manche: некоторый
mehrere: несколько, некоторые
meinen: полагать, думать
meinetwegen: пожалуй, извольте
meiste: наибольший
meistens: большей частью
melden: сообщать
menschlich: человечный
merken: замечать, запоминать
merkwьrdig: необычный, удивительный
messen: мерить, осматривать
mieten: арендовать
mindestens: по меньшей мере
missfallen: не нравиться (кому-либо)
mit fahren: ехать с
mit machen: принимать участие
mit nehmen: брать с собой
mit teilen: сообщать, передавать
miteinander: вместе, друг с другом
mittlere: средний
montieren: монтировать
mцgen: любить
mцglich: возможный
mьde: усталый, уставший
mьndlich: устный
nachdem: после того, как
nachdenken: обдумывать
nachschlagen: справиться по справочнику
nachts: ночью, по ночам
nebenan: рядом
nett: милый, славный, симпатичный
neugierig: любопытный
neulich: недавно
nicht nur ... sondern auch: не только ... но и
nie: никогда
niedrig: низкий
notwendig: нужный, необходимый
nutzen: годиться, быть полезным
nдher: детальный
nдmlich: так как
nцtig: нужный, необходимый
nьtzen: быть полезным
obwohl: несмотря на то, что; хотя
offen: открытый
offenbar: очевидно, явно
organisieren: организовывать
originell: оригинальный
passen: подходить, сочетаться
passieren: случаться, происходить
per: по, на
perfekt: превосходный
pflegen: ухаживать
politisch: политический
positiv: положительный
praktisch: практичный
protestieren: протестовать
prьfen: проверять, испытывать
putzen: чистить
quer: поперёк
raten: советовать
realisieren: реализовать
rechte: правый
reden: говорить, разговаривать
regelmдЯig: регулярный
regeln: регулировать
regieren: править, управлять
regnen: идет дождь
reiben: тереть
reich: богатый
reichen: быть достаточным, хватать
rein: чистый
reizen: раздражать
retten: спасать
riechen: пахнуть, нюхать
ruhen: отдыхать
ruhig: спокойный, тихий
rund: круглый
rund um: вокруг
rдumen: убирать, освобождать
rьckwдrts: обратно, назад
salzen: солить
sammeln: собирать
sauber: чистый, опрятный
schaffen: создавать, творить
schauen: смотреть, глядеть
scheiden: расторгать (брак)
scheinbar: по-видимому, видимо
scheinen: светить, сиять
schimpfen: ругать, обругать
schlagen: бить, ударять
schlank: стройный, тонкий
schlecht: плохой, скверный, дурной
schleppen: тащить
schlieЯen: запирать, завершать
schlieЯlich: в конце концов
schlimm: плохой
schmal: узкий, тонкий
schmecken: пробовать (на вкус)
schmutzig: грязный
schneiden: резать, отрезать
schneien: идет снег
schrecklich: ужасный
schuldig: виновный
schwach: слабый
schweigen: молчать, замечать
schwer: тяжелый, трудный
schwierig: трудный, затруднительный
schwitzen: потеть, париться
schдlen: чистить (от кожуры и т.п.)
schцn: красивый, прекрасный
schьtzen: защищать
segeln: плавать, плыть
seit: с тех пор как
selbstverstдndlich: само собой разумеещийся
selbstдndig: самостоятельный
selten: редкий
seltsam: странный
sich anhцren: приятно (неприятно) на слух
sich aufregen: волноваться, возбуждаться
sich ausruhen: отдыхать
sich beschweren: жаловаться
sich bewerben: подавать заявление о приёме на работу
sich erinnern: помнить, вспоминать
sich erkдlten: простужаться
sich schдmen: стыдиться
sich verspдten: опаздывать, запаздывать
sichern: обеспечивать, гарантировать
sinken: тонуть, опускаться
so ..., dass: настолько ..., что
sobald: как только, едва
sofort: сейчас, тотчас, немедленно
sogar: даже
solch: такой, подобный
sondern: но, а (после отрицания)
sorgen: заботиться
sozial: социальный, общественный
sparen: экономить
spazieren: расхаживать, прогуливаться, гулять
spьren: ощущать
staatlich: государственный
stampfen: толочь, мять
stark: сильно, очень
starten: стартовать
stecken: втыкать, засовывать
stehlen: воровать
steil: отвесный
sterben: умирать
steuern: направлять, вести (транспорт, беседу)
still: тихий, нешумный
stimmen: соответствовать истине, быть верным
stolz: гордый
stoppen: остановить
stoЯen: толкать, бодать
streichen: гладить, красить, зачеркивать
streiken: бастовать
streiten: спорить, ссориться
stдdtisch: городской
stцren: мешать (кому-либо), беспокоить (кого-либо)
stьrzen: опрокидывать, сталкивать
stьtzen: поддерживать, опираться
tanken: заправляться (топливом)
tapezieren: оклеивать обоями
taugen: годиться, быть (при)годным
tauschen: менять
technisch: технический
teilnehmen: принимать участие
teilweise: отчасти
toben: бушевать
toll: бешеный
tot: мёртвый, неживой
tragen: носить (в т.ч. одежду, прическу)
traurig: печальный, грустный
treffen: попадать, встречать
trennbar: отделяемый, разделимый
trennen: отделять, разъединять
treten: наступать
treu: верный, преданный
tropfen: капать
trotz: несмотря на
trotzdem: несмотря на это, всё же
tцten: убивать
umdrehen: поворачивать, вращать
umfallen: упасть, опрокинуть
umgekehrt: наоборот
umrьhren: мешать, перемешивать
umziehen: переодевать, переезжать
unbedingt: безусловно, непременно
ungefдhr: примерный, примерно
unglaubliche: (нечто) невероятное
unterbringen: помещать
unterhalten: поддерживать
unterrichten: преподавать
unterscheiden: различать, распознавать
unterwegs: по пути
verabreden: договариваться
verantwortlich: ответственный
verbessern: улучшать
verbieten: запрещать
verbinden: перевязывать
verboten: запрещенный
verbrauchen: потреблять, расходовать
verbringen: проводить (время)
verdienen: зарабатывать (деньги)
vergeblich: напрасный
vergessen: забывать
vergleichen: сравнить
vergrцЯern: увеличиваться
verhaften: арестовать
verhindern: предотвращать
verkaufen: продавать
verlangen: требовать
verlassen: полагаться на кого-либо
verletzen: поранить
verlieben: влюбиться
verlieren: терять, проигрывать
verloren gehen: теряться, потеряться
verlдngern: удлиннять
vermieten: сдвать в аренду
vermitteln: передавать (опыт)
vermuten: предполагать, догадываться
vernьnftig: разумный
verraten: предавать
verrьckt: сумасшедший
verrьhren: размешивать, смешивать
verschieden: различный
verschlafen: просыпать, заспанный, сонный
verschlechtern: ухудшаться
verschreiben: прописывать
versprechen: обещать
verspдten: опаздывать
verstecken: прятать
versuchen: пробовать, пытаться
verteilen: раздавать
verwechseln: перепутать
verwenden: употреблять, использовать
verzichten: отказываться
verдndern: изменяться
verцffentlichen: опубликовывать
voll: полный, заполненный, наполненный
von selbst: само собой
vorbereiten: готовиться
vorgestern: позавчера
vorhaben: собираться, намереваться
vorkommen: случаться
vorn: впереди
vorschlagen: предлагать
vorstellen: представлять(ся)
vorziehen: предпочитать
wach: бодрый, живой
wachsen: расти
wackeln: шататься
wahr: истинный, настоящий
wahrscheinlich: вероятный
wandern: путешествовать (пешком)
warm: тёплый
warnen: предостерегать
wechseln: менять, переменять
wecken: будить, разбудить
weder ... noch: ни ... ни
wegschьtten: выливать
wehen: дуть, веять
wehtun: болеть, огорчать
weich: мягкий
weil: потому что, так как
weinen: плакать (о ком-либо, о чём-либо)
weit: дальний
wenigstens: по крайней мере, по меньшей мере
wertvoll: драгоценный
widerholen: повторять
wiedersehen: вновь увидеть (встретить)
wozu: к чему, для чего
wunderbar: чудесный, удивительный
wundern: удивлять
wдhrend: в то время как
zahlen: платить
zahlreich: многочисленный
zeichnen: рисовать
zelten: жить в палатке
zerstцren: разрушить
ziehen: тянуть, тащить
ziemlich: примерно, приблизительно
zittern: дрожать, трястись
zudrehen: завернуть, повернуться
zufrieden: довольный, удовлетворённый
zuhцren: слушать, прислушиваться
zuletzt: напоследок, под конец
zuliebe: из любезности
zunehmen: прибывать, увеличиваться, толстеть
zuschauen: наблюдать
zuschicken: присылать
zuverlдssig: надёжный
zwingen: заставлять
дhnlich: похожий, сходный
дndern: менять, переделывать
дngstlich: боязливый
дrgerlich: сердитый, раздраженный
дrgern: злить, сердить
дussern: выражать, обнаруживать
цffentlich: открытый, гласный
цffnen: открывать
цfter: чаще
ьben: упражнять, тренировать
ьberall: везде, повсюду
ьberhaupt: вообще
ьberhaupt nicht: совсем (вообще) нет (не)
ьberlegen: обдумывать, соображать
ьbernachten: переночевать
ьbernehmen: принимать, получать
ьberraschen: поражать, удивлять
ьbersetzen: переводить
ьberweisen: переводить (деньги)
ьberzeugen: убеждать, переубеждать
ьblich: обычный
ьbrig: остальной
