antworten: отвечать
bekommen: получать
bieten: предлагать
entscheiden: решаться
entschuldigen: извинять
fahren: ехать
funktionieren: функционировать
gehen: идти
können: мочь
korrigieren: коректировать
kosten: стоить
sagen: говорить
spülen: полоскать
stimmen: голосовать
waschen: мыть
wechseln: менять
die Antwort(-en): ответ
das Auto(-s): авто
die Batterie(-n): батарея
das Benzin: бензин
das Bett(-en): кровать
das Bild(-er): картина
der Fehler(-): ошибка
der Fernsehapparat(-e): телевизор
das Foto(-s): фото
das Geld: деньги
das Geschäft(-e): магазин
die Gruppe(-n): группа
das Haus(-er): дом
das Handy(-s): мобильный телефон
der Haushalt(-e): обиход
der Herd(-e): плита
die Idee(-n): идея
die Kamera(-s): камера
die Karte(-n): карта
die Kassette(-n): касета
die Küche(-n): кухня
der Kugelschreiber: шариковая ручка
der Kühlschrank(-e): холодильник
die Lampe(-n): лампа
die Minute(-n): минута
die Person(-en): персона
das Problem(-e): проблема
das Programm(-e): программа
das Radio(-s): радио
das Regal(-e): полка
der Schrank(-e): шкаф
die Steckdose(-n): розетка
der Stecker (-): штекер
der Stuhl(-e): стул
der Tisch(-e): стол
der Topf(-e): кастрюля, горшок
die Uhr(-en): часы
das Waschbecken(-): умывальник
die Waschmaschine(-n): стиральная машина
der Wasserhahn(-e): кран
der Wert(-e): цена, значение
das Wort(-er): слово
die Zeit: время
ähnlich: похожий
bequem: удобный
ehrlich: правдивый
kaputt: поломанный
leer: пустой
lustig: смешной
modern: современный
originell: оригинальный
praktisch: практичный
auch: и
heute: сегодня
sehr: очень
viele: много
es: это
oder: или
sondern: а  
zu: к
alle sein: закончено
aus sein:  выключено
