backen: печь
bekommen: получать
bestellen: заказывать
bezahlen: оплачивать
brauchen: нуждаться
erkennen: узнавать
erzählen: рассказывать
essen: кушать
glauben: варить
kennen: мочь
kochen: готовить
mögen: желать
nehmen: брать
schmecken: пробовать
trinken: пить
üben: заниматься
das Abendessen: ужин
der Alkohol: алкоголь
die Anzeige: объявление
der Apfel: яблоко
das Bier: пиво
die Bohne: бобы
das Brot: хлеб
das Brötchen: булка
die Butter: масло
die Dose: банка
das Ei: яйца
das Eis: мороженное
die Erdbeere: клубника
der Euro: евро
der Export: экспорт
der Fisch: рыба
die Flasche: бутылка
das Fleisch: мясо
die Frage: вопрос
die Frucht: фрукт
das Frühstück: завтрак
die Gabel: вилка
der Gasthof: гостиница
das Gemüse: овощи
das Gericht: суд
das Gespräch: разговор
das Getränk: напиток
das Gewürz: специи
das Glas: стакан
das Gramm: грамм
das Hähnchen: цыпленок
der Kaffee: кофе
die Kartoffel: картофель
der Käse: сыр
das Kilo: килограм
die Kiste: ящик
das Kotelett: котлета
der Kuchen: пирог
die Limonade: лимонад
der Liter: литр
der Löffel: ложка
die Marmelade: мармелад
das Mehl: мука
das Messer: нож
die Milch: молоко
das Mineralwasser: мин. вода
der Nachtisch: десерт
der Obstkuchen: фруктовый пирог
das Öl: растительное масло
der Pfeffer: перец
das Pfund: фунт
der Preis: цена
der Reis: рис
der Rotwein: красное вино
der Saft: сок
die Sahne: сливки
der Salat: салат
der Schinken: шинка
die Schokolade: шоколад
die Soße: соус
die Speisekarte: меню
das Spülmittel: моющее средство
das Steak: стейк
die Suppe: суп
die Tasse: чашка 
der Tee: чай
der Teller: тарелка
die Tomate: помидор
die Vorspeise: закуска 
die Wäsche: стирка
die Wurst: колбаса
der Zettel: стикер
der Zucker: сахар
die Zwiebel: лук
billig: дешевый
bitter: горький
dunkel: темный
eng: тесный узкий
fantastisch: фантастический
fett: жирный
frisch: свежий
groß: большой
grün: зеленый
hart: черствый
hell: светлый
hoch: высокий
kalt: холодный
lieber: любимый
mild: нежный
nah: близко
normal: нормальный
rot: красный
salzig: соленый
sauer: кислый
scharf: острый
schlank: худой
stark: сильный
süß: сладкий
trocken: сухой
typisch: типичный
warm: теплый
wichtig: влажный
abends: вечером
besonders: очень
danach: после
dann: потом
fast: быстро
ganz: полностью
genug: хватит
gern: охотно
lieber: любить(предпочитать)
manchmal: иногда
mittags: в обед
morgens: утром
nachmittags: после обеда
natürlich: конечно
nur: только
oben: наверху, вверху
oft: часто
so: так
sofort: сейчас же
überall: везде
unten: внизу
verschieden: разный, некоторые
vorwiegend: предпочтительный
zuerst: во первых
zusammen: вместе
alle: все
als: как
doch: да (утверждение)
etwas: что-то
jeder: каждый
mit: с
pro: за (раз)
zu: к
viel: много
welcher?: какой?
es gibt: имеется
vor allem: так как, перед тем
das Gramm: грамм
das Kilogramm: килограмм
