anfangen: начинать
anziehen: надевать
aufhören: переставать
aufmachen: открывать
aufräumen: убирать
aufstehen: вставать
bedienen: обслуживать
beschreiben: описывать
bringen: приносить
dürfen: мочь
duschen: принимать душ
einkaufen: покупать
einladen: приглашать
feiern: праздновать
fernsehen: смотреть телевизор
fotografieren: фотографировать
frühstücken: завтракать
holen: забирать
kontrollieren: контролировать
können: мочь
messen: мерить
mitbringen: приносить с собой
mitkommen: приходить с кем-либо
müssen: быть должным
ordnen: приводить
Rad fahren: кататься на велосипеде
rauchen: курить
schlafen: спать
schneiden: резать
schwimmen: плавать
sehen: смотреть
spazieren gehen: гулять
stattfinden: происходить
stören: мешать
tanzen: танцевать
treffen: встретить
vergessen: забывать
vergleichen: сравнивать
vorbereiten: приготовить
vorhaben: собираться
zeichnen: рисовать
zuhören: слушать
der Abend (-e): вечер
die Ansichtskarte (n): открытка
die Arbeit: работа
der Ausflug: вылет
der Bäcker: пекарь
die Bank(-en): банк
die Bar(-s): бар
die Bibliotek(-en): библиотека
das Buch(-en): книга
das Cafe(-s): кафе
die Diskothek(-en): дискотека
der Donnerstag: четверг
die Dusche: душ
der Eintritt: вход, вступление
das Essen: еда
das Fernsehen: телевидение
das Fieber: жар
der Film(-e): фильм
der Freitag: пятница
die Freizeit: свободное время
die Friseurin(-nen): парикмахерша
der Friseur: парикмахер
der Gast: гость
der Gruß: приветствие
der Juli: июль
die Kellnerin: официантка
der Kellner: официант
das Kino(s): кино
das Kleid(-er): платье
das Konzert(-e): концерт
das Krankenhaus(-er): больница
die Krankenschwester(-n): медсестра
die Lehrerin: учительница
der Lehrer: учитель
die Mannschaft(-en): команда
die Maschine(-n): машина
das Meer(-e): море
der Mensch(-en): человек
der Mittag(-e): полдень
das Mittagessen: обед
der Mittwoch: среда
der Montag: понедельник
die Musik: музыка
der Passagier(-e): пассажир
die Pause(-n): пауза
das Restaurant(-s): ресторан
der Samstag: четверг
der Satz(-e): предложение
das Schild(-er): таблица
das Schwimmbad: бассейн
die Situation(-en): ситуация
der Sonnabend: суббота
das Sonnenbad(-r): загарать
der Sonntag: воскресенье
der Spaziergang(-r): прогулка
der Tanz(-e): танец
die Torte(-e): торт
die Uhrzeit(-en): время
der Verband(-e): перевязка
das Viertel: четверть
der Vortrag(-e): доклад
die Wohnung(-en): квартира
die Zeitung(-en): газета
die Zigarette(-n): сигареты
früh: рано
geöffnet: открыто
geschlossen: закрыто
herrlich: чудесный
herzlich: сердечный
leise: тихо
lieb: милый
nächst: следующий
nett: добрый, приветливый
obligatorisch: обязательно
spät: поздно
verboten: запрещено
eben: только что
heute: сегодня
immer: всегда
meistens: часто
morgen: утром
nie: никогда
selbst: сам
vielleicht: может быть
also: и так
auf: на
bis: до
gegen: против
jemand: кто-то
nach: после
selbst: сам
von_bist_: с_до_
wann?: когда
warum?: почему?
wie lange?: как долго?
zwischen: между
Achtung!: Внимание!
Betten machen: застилать постель
das nächste Mal: в следующий раз
frei haben: свободное время
Leid tun: жаль
los sein: начало движения
Lust haben:  иметь настроение
Pause machen: делать паузу
Schön: Красиво
spät sein: поздно
Tschüs!: Пока!
