arbeiten: работать
buchstabieren: произносить по буквам
fragen: спрашивать
haben: иметь
heißen: называться
hören: слышать
kommen: приезжать
leben: жить
lesen: читать
machen: делать
meinen: думать
möchten: хотеть
reisen: путешествовать
schreiben: писать
sein: быть
sprechen: говорить
studieren: изучать
warten: ожидать
werden: становиться
wohnen: проживать
der Alter: возраст
der Ausländer: иностранец
der Beruf: профессия
Deutschland: Германия
die Eltern: родители
der Familienname: фамилия
der Familienstand: семейное положение
der Fotograf: фотограф
die Frau: госпожа
der Geburtstag: день роождения
die Hausfrau: домохозяйка
der Herr: господин
das Hobby: хобби
das Jahre: год
der Kaufmann: бизнесмен
die Kauffrau: бизнесменша
das Kind: ребенок
die Kinder: дети
der Kurs: кирс
das Land: страна
die Leute: люди
die Lösung: решение
der Mechaniker: механик
der Monat: месяц
die Monate: месяцы
der Ort: район
Österreich: Автрия
Postkarte: почтовая открытка
Postleitzahl: почтовый индекс
die Schülerin: школьница
die Seite: страница
die Sekretärin: секретарша
die Straße: улица
der Student: студент
die Studentin: студентка
der Tag: день
die Tage: дни
das Telefon: телефон
die Telefonnummer: номер телефона
der Vorname: имя
der Wort: слово
die Zahl: число
die Zahlen: числа
alt: старый
berufstätig: профессиональный
frei: свободный
geschieden: разведенный
gut: хороший
klein: маленький
ledig: не замужем
neu: новый
verheiratet: женатый
bitte: пожалуйста
da: здесь
erst: лишь
etwa: почти
hier: здесь
jetzt: теперь
leider: к сожалению
nicht: не
noch: еще
noch einmal: еще раз
schon: уже
übrigens: между прочим
aber: но
aus: из
das: этот
dein: твой
denn: же
in: в
ja: да
man: люди
mein: мой
mit: с
nein: нет 
und: и
von: из
was?: что?
wer?: кто?
wie?: как?
wie viel?: сколько? 
wo?: где?
woher?: откуда
wohin?: куда?
